apple - jab³ko
pear - gruszka
peach - brzoskwinia
apricot - morela
cherry - wiœnia-czereœnia
plum - œliwka
blackcurrant - czarna-porzeczka
redcurrant - czerwona-porzeczka
blueberry - czarna-jagoda
raspberry - malina
strawberry - truskawka
cranberry - ¿urawina
gooseberry - agrest
banana - banan
lemon - cytryna
greengage - renkloda
orange - pomarañcza
grapefruit - grejpfrut
grape - winogrono
pineapple - ananas
passion fruit - marakuja
melon - melon
watermelon - arbuz
cabbage - kapusta
Brussels sprout - brukselka
cauliflower - kalafior
carrot - marchew
cress - rze¿ucha
cucumber - ogórek
onion - cebula
garlic - czosnek
lettuce - sa³ata
radish - rzodkiewka
leek - por
celery - seler
parsley - pietruszka
potato - ziemniak
tomato - pomidor
pepper - papryka
spinach - szpinak
beet - burak
beans - fasola
French beans - fasolka-szparagowa
green peas - groszek-zielony
sweetcorn - kukurydza
asparagus - szparagi
garlic - czosnek
horseradish - chrzan
mushroom - grzyb
butter - mas³o
cheese - ser
milk - mleko
yoghurt - jogurt
cottage cheese - twaróg, bia³y ser
egg - jajo
hard boiled egg - jajo-gotowane na - twardo
soft boiled egg - jajo-gotowane na - miêkko
fried, sunny side up egg - jajo sadzone
scrambled eggs - jajecznica
poached eggs - jajka-w koszulkach
omelette - omlet
bread - chleb
croissant - rogal
French bread - bagietka
roll, bun - bu³ka
wholemeal bread - chleb razowy
